####################################
#                                  #
#  K                               #
#                                  #
#############################      #
                            #      #
                            #      #
                            #      #
                            #      #
                            #      #
#############################      #
#                                  #
#  P                               #
#                                  #
####################################