######################################################################
#                                  #                                 #
#  K                               #                                 E
#                                  #                                 #
##############################     #     #############################
                             #     #     #
                             #     #     #############################
                             #     #                                 #
                             #     #                                 #
                             #     #                                 #
##############################     ############################      #
#                                  #                                 #
#  P                               L                                 #
#                                  #                                 #
######################################################################